00000000000
00000000000
10020003000
12000300000
20000000010
30000030010
00000000010
00000000010
30000200000
00000000000
00000000010