333333  333
00000000000
 0020003000
12000300000
20000000010
30000030010
00000000010
00000000010
3    221
00000000000
00000000010